1111111111111111111111111
1P00000000000010000000001
1011110111111010111110101
1011110111111010111110101
1011110111111010111110101
1000000000000000000000001
1011110111111110111110101
1011110111111110111110101
1000010000000000010000101
1111010111111110111011101
1111010111111110111011101
1000000000000010000000001
1011110111111010111110101
1011110111111010111110101
10111C0111111010111110101
10000000000000000000000E1
1111111111111111111111111