1111111111111111111111111111111
1P000000000C00000000000E0000011
1011101111101111111111011110011
1011101111101111111111011110011
1011101111101111111111011110011
1C00000000000000000000000000C11
1111111111111111111111111111111