11111111111111111111111111111111111111111
1P000000000000000000C0000000000000E000001
10111011101111111011101111111110111110101
10111011101111111011101111111110111110101
10111011101111111011101111111110111110101
10111011101111111011101111111110111110101
1C0000000000000000000000000000000000000C1
11111111111111111111111111111111111111111
