11111
10001
1PEC1
10001
111111