



1111111111111111111111111111
1CCCCCCCCGGGGGGGCCCCCCCCCCE1
1CCCCCCCCGGGPGGGCCCCCCCCCCC1
1CCCCCCCCGGGGGGCCCCCCCCCCCC1
1111111111111111111111111111






