



1111111111111111111111111111
1CCCCCCCCCCCCCCCCCCCCCCCCCE1
1PCCCCCCCCCCCCCCCCCCCCCCCCC1
1CCCCCCCCCCCCCCCCCCCCCCCCCC1
1111111111111111111111111111






