11111111111111111
100C0000C000C0001
1C000001110000001
11000C000001100C1
10001110000C00001
1P00C000C0010C0E1
11111111111111111